NO textures/px1blue.png
SO textures/x2pixbluered.png
WE textures/Attack.png
EA textures/full.png
F 101,67,33
C 70,130,180

1111111111111111111111111111111
10000000000100000000000N0000001
1000000000100000000000000000001
1111111111111111111111111111111