NO textures/bricksx64.png
SO textures/b.png
WE textures/Attack.png
EA textures/Dead.png
F 220,100,0
C 225,30,0
1111111111111111111111111
1000000000110000000000001
1011000001110000000000001
1001000000000000000000001
11111111101100000111000001
100000000011000001110111111111111
11110111111111011100000000011
11110111111111011101010010001
11000000110101011100000010011
10000000000000001100000010001
10000000000000001101010010001
11000001110101011111N111100111
11111111111111111101111011111
11111111111111111100110011
1111111111111111111111111